1.341483160621761705e-01
1.618864074367985517e-01
9.714239059438275481e-01
9.290368160766151462e-01
1.574944071588366967e-01
1.531411677753141132e-01
1.602858601327207810e-01
2.451220365060493844e-01
