9.868481010198593140e-02
3.105669021606445312e-01
1.393197327852249146e-01
1.131972819566726685e-01
1.219047605991363525e-01
1.073922887444496155e-01
1.306122392416000366e-01
1.160997748374938965e-01
1.306122392416000366e-01
1.422222256660461426e-01
1.306122392416000366e-01
1.277097463607788086e-01
1.393197327852249146e-01
1.190022677183151245e-01
1.248072534799575806e-01
9.287981688976287842e-02
9.287981688976287842e-02
9.287981688976287842e-02
9.287981688976287842e-02
9.287981688976287842e-02
9.287981688976287842e-02
9.287981688976287842e-02
9.287981688976287842e-02
9.287981688976287842e-02
9.287981688976287842e-02
9.287981688976287842e-02
9.287981688976287842e-02
9.287981688976287842e-02
1.160997748374938965e-01
9.287981688976287842e-02
1.102947816252708435e-01
9.287981688976287842e-02
9.287981688976287842e-02
9.287981688976287842e-02
9.287981688976287842e-02
1.596371829509735107e-01
1.102947816252708435e-01
9.287981688976287842e-02
9.287981688976287842e-02
1.015873029828071594e-01
1.102947816252708435e-01
1.335147321224212646e-01
1.277097463607788086e-01
1.190022677183151245e-01
1.277097463607788086e-01
1.335147321224212646e-01
1.306122392416000366e-01
1.248072534799575806e-01
1.277097463607788086e-01
1.393197327852249146e-01
1.625396758317947388e-01
1.044897958636283875e-01
1.306122392416000366e-01
9.287981688976287842e-02
9.287981688976287842e-02
9.287981688976287842e-02
1.015873029828071594e-01
1.236462593078613281e+00
9.287981688976287842e-02
1.770521551370620728e-01
