9.868481010198593140e-02
9.287981688976287842e-02
9.287981688976287842e-02
1.044897958636283875e-01
1.364172399044036865e-01
1.044897958636283875e-01
1.131972819566726685e-01
1.160997748374938965e-01
1.248072534799575806e-01
1.160997748374938965e-01
1.277097463607788086e-01
7.053061127662658691e-01
1.190022677183151245e-01
