9.868481010198593140e-02
9.287981688976287842e-02
9.287981688976287842e-02
1.015873029828071594e-01
2.380045354366302490e-01
1.248072534799575806e-01
1.131972819566726685e-01
1.219047605991363525e-01
1.131972819566726685e-01
1.364172399044036865e-01
5.311564803123474121e-01
1.683446764945983887e-01
