9.868481010198593140e-02
9.287981688976287842e-02
1.944671273231506348e-01
1.190022677183151245e-01
1.190022677183151245e-01
1.219047605991363525e-01
1.248072534799575806e-01
1.131972819566726685e-01
1.335147321224212646e-01
9.287981688976287842e-02
9.287981688976287842e-02
9.287981688976287842e-02
1.567346900701522827e-01
