9.868481010198593140e-02
9.287981688976287842e-02
9.287981688976287842e-02
1.131972819566726685e-01
1.190022677183151245e-01
1.190022677183151245e-01
1.073922887444496155e-01
1.131972819566726685e-01
1.248072534799575806e-01
1.248072534799575806e-01
1.102947816252708435e-01
9.287981688976287842e-02
2.438095211982727051e-01
