9.868481010198593140e-02
9.287981688976287842e-02
1.102947816252708435e-01
1.160997748374938965e-01
1.480272114276885986e-01
1.393197327852249146e-01
1.364172399044036865e-01
1.422222256660461426e-01
1.364172399044036865e-01
1.567346900701522827e-01
1.393197327852249146e-01
1.190022677183151245e-01
9.287981688976287842e-02
6.095238327980041504e-01
9.287981688976287842e-02
9.287981688976287842e-02
9.578230977058410645e-02
