9.868481010198593140e-02
9.287981688976287842e-02
1.131972819566726685e-01
9.287981688976287842e-02
9.287981688976287842e-02
1.248072534799575806e-01
1.190022677183151245e-01
1.306122392416000366e-01
1.422222256660461426e-01
1.509297043085098267e-01
1.248072534799575806e-01
1.509297043085098267e-01
8.126984238624572754e-01
1.451247185468673706e-01
