9.868481010198593140e-02
9.287981688976287842e-02
1.219047605991363525e-01
1.335147321224212646e-01
1.422222256660461426e-01
1.393197327852249146e-01
1.393197327852249146e-01
1.480272114276885986e-01
1.335147321224212646e-01
1.538321971893310547e-01
1.190022677183151245e-01
9.287981688976287842e-02
9.287981688976287842e-02
2.118820846080780029e-01
