9.868481010198593140e-02
2.321995496749877930e-01
1.335147321224212646e-01
1.393197327852249146e-01
1.277097463607788086e-01
1.422222256660461426e-01
1.335147321224212646e-01
1.451247185468673706e-01
1.335147321224212646e-01
1.596371829509735107e-01
6.704761981964111328e-01
1.422222256660461426e-01
