9.868481010198593140e-02
1.741496622562408447e-01
1.422222256660461426e-01
1.509297043085098267e-01
1.219047605991363525e-01
1.422222256660461426e-01
1.451247185468673706e-01
1.538321971893310547e-01
1.248072534799575806e-01
1.422222256660461426e-01
1.509297043085098267e-01
1.451247185468673706e-01
1.451247185468673706e-01
1.422222256660461426e-01
1.422222256660461426e-01
1.248072534799575806e-01
9.287981688976287842e-02
9.287981688976287842e-02
9.287981688976287842e-02
1.335147321224212646e-01
1.335147321224212646e-01
9.287981688976287842e-02
1.770521551370620728e-01
1.422222256660461426e-01
1.422222256660461426e-01
1.306122392416000366e-01
1.422222256660461426e-01
1.364172399044036865e-01
1.509297043085098267e-01
1.422222256660461426e-01
1.335147321224212646e-01
1.422222256660461426e-01
1.190022677183151245e-01
1.625396758317947388e-01
1.451247185468673706e-01
1.683446764945983887e-01
1.073922887444496155e-01
1.596371829509735107e-01
2.873469293117523193e-01
1.044897958636283875e-01
