1.567346900701522827e-01
1.190022677183151245e-01
1.306122392416000366e-01
1.451247185468673706e-01
1.393197327852249146e-01
1.509297043085098267e-01
1.248072534799575806e-01
1.335147321224212646e-01
1.509297043085098267e-01
1.654421836137771606e-01
1.044897958636283875e-01
1.451247185468673706e-01
1.509297043085098267e-01
1.422222256660461426e-01
1.422222256660461426e-01
9.287981688976287842e-02
9.287981688976287842e-02
9.287981688976287842e-02
1.335147321224212646e-01
1.393197327852249146e-01
1.393197327852249146e-01
1.277097463607788086e-01
9.287981688976287842e-02
9.287981688976287842e-02
9.287981688976287842e-02
1.277097463607788086e-01
1.393197327852249146e-01
1.451247185468673706e-01
1.393197327852249146e-01
1.393197327852249146e-01
1.277097463607788086e-01
1.248072534799575806e-01
1.683446764945983887e-01
1.538321971893310547e-01
2.844444513320922852e-01
1.277097463607788086e-01
