9.868481010198593140e-02
9.287981688976287842e-02
9.287981688976287842e-02
1.131972819566726685e-01
1.248072534799575806e-01
1.480272114276885986e-01
1.451247185468673706e-01
1.451247185468673706e-01
1.364172399044036865e-01
1.248072534799575806e-01
1.712471693754196167e-01
1.451247185468673706e-01
1.306122392416000366e-01
1.451247185468673706e-01
9.287981688976287842e-02
9.287981688976287842e-02
9.578230977058410645e-02
9.287981688976287842e-02
1.654421836137771606e-01
9.287981688976287842e-02
9.287981688976287842e-02
9.287981688976287842e-02
1.219047605991363525e-01
1.451247185468673706e-01
1.451247185468673706e-01
1.364172399044036865e-01
1.393197327852249146e-01
1.422222256660461426e-01
1.509297043085098267e-01
1.393197327852249146e-01
1.509297043085098267e-01
1.567346900701522827e-01
3.018594086170196533e-01
9.287981688976287842e-02
1.364172399044036865e-01
