9.868481010198593140e-02
9.287981688976287842e-02
9.287981688976287842e-02
1.160997748374938965e-01
1.277097463607788086e-01
1.567346900701522827e-01
1.480272114276885986e-01
1.480272114276885986e-01
1.480272114276885986e-01
1.335147321224212646e-01
1.422222256660461426e-01
1.393197327852249146e-01
1.219047605991363525e-01
1.422222256660461426e-01
1.451247185468673706e-01
1.364172399044036865e-01
1.393197327852249146e-01
1.335147321224212646e-01
9.287981688976287842e-02
9.287981688976287842e-02
9.287981688976287842e-02
1.393197327852249146e-01
1.277097463607788086e-01
1.596371829509735107e-01
1.306122392416000366e-01
1.248072534799575806e-01
1.364172399044036865e-01
1.422222256660461426e-01
1.364172399044036865e-01
1.335147321224212646e-01
1.480272114276885986e-01
1.509297043085098267e-01
1.509297043085098267e-01
2.612244784832000732e-01
1.538321971893310547e-01
