1.299384715025906634e-01
1.688017231606393775e-01
9.601567602873938290e-01
9.209514090587958002e-01
1.659955257270693540e-01
1.552845528455284452e-01
1.624978730644886793e-01
2.543534512903000144e-01
