1.290479274611398830e-01
1.671012356875637705e-01
9.601567602873938290e-01
9.209514090587958002e-01
1.659955257270693540e-01
1.533628972653362788e-01
1.615620214395099563e-01
2.528848171200783201e-01
