1.508707538081299759e-01
1.721896013967652017e-01
7.003862250501693421e-01
7.082806463694312216e-01
1.365316082708171175e-01
1.503082225103365421e-01
1.485135735796293543e-01
2.388132662941606088e-01
