1.373056994818652732e-01
1.600907029478458032e-01
9.595300261096605388e-01
9.256120527306967993e-01
1.298932384341636992e-01
1.571175428233904381e-01
1.575365770670296151e-01
2.413310961968680168e-01
