1.239446368737144727e-01
1.620708495347885914e-01
8.218451687374039860e-01
7.534968813681750532e-01
1.353777961289989729e-01
1.366584982790692293e-01
1.400401203004429662e-01
2.181336034366062604e-01
