1.216172419380975589e-01
1.660420215786485021e-01
9.421974783035860224e-01
8.880855077019804700e-01
1.601439496176338406e-01
1.512617479464219705e-01
1.641969000170328818e-01
2.425600448147888777e-01
