1.430134469334022884e-01
1.771851805720880413e-01
7.621677630810004267e-01
7.171218498410769637e-01
1.459040726183724324e-01
1.611219593147387164e-01
1.547032360265213902e-01
2.401936751841439455e-01
