1.415410385259631421e-01
1.767912772585669701e-01
9.612359550561797583e-01
9.261654540555106507e-01
1.725190839694656364e-01
1.732142857142857095e-01
1.688159437280187525e-01
2.736486486486486291e-01
