1.402738664801283230e-01
1.749134178338279388e-01
7.926608730421017546e-01
7.411963426641472452e-01
1.570641384771931937e-01
1.558626409884348030e-01
1.526046278968476166e-01
2.310449344860022181e-01
