1.390284757118928072e-01
1.666666666666666574e-01
9.651685393258426782e-01
9.299380220964699184e-01
1.969465648854961948e-01
1.693877551020408212e-01
1.682297772567409033e-01
2.700289575289575028e-01
