1.215059088463279757e-01
1.566931323334192216e-01
8.510396026799037505e-01
7.831400949893414509e-01
1.391690511223034055e-01
1.310936927428817400e-01
1.359880819515416894e-01
2.116094755534059513e-01
