1.327699715769357913e-01
1.675599545669780033e-01
8.151875198413914836e-01
7.734767948265427462e-01
1.535584419510479526e-01
1.503821896935994551e-01
1.468856633292465463e-01
2.317347512084629857e-01
