1.278615298715801152e-01
1.647196261682243035e-01
9.668539325842696597e-01
9.277822689302075432e-01
1.908396946564885621e-01
1.660714285714285643e-01
1.746776084407971885e-01
2.673745173745173953e-01
