1.273031825795644945e-01
1.635514018691588689e-01
9.668539325842696597e-01
9.277822689302075432e-01
1.908396946564885621e-01
1.645408163265306145e-01
1.743845252051582639e-01
2.659266409266409226e-01
