1.465008710168645145e-01
1.741500718388196978e-01
7.874206031466128852e-01
7.465913322679530451e-01
1.564042416218444920e-01
1.555984227663277375e-01
1.511031796986112008e-01
2.356819262098724110e-01
