1.407035175879396971e-01
1.658878504672897103e-01
9.629213483146067398e-01
9.277822689302075432e-01
1.908396946564885621e-01
1.701530612244897822e-01
1.735052754982414902e-01
2.709942084942085216e-01
