1.411472723412528496e-01
1.758056112560444917e-01
7.739903619266121915e-01
7.243032919509905243e-01
1.517533893170563974e-01
1.588255385955098242e-01
1.532769458134830842e-01
2.365487665472795209e-01
