1.344743810893042901e-01
1.626960056867355064e-01
7.962810759790757142e-01
7.466260774359518848e-01
1.352976049841800310e-01
1.391501159689545186e-01
1.393560143609954560e-01
2.247654488641759596e-01
