1.260524611398963768e-01
1.780977213467860865e-01
9.550947093403004962e-01
9.125520056519349499e-01
1.561521252796420622e-01
1.470805617147080691e-01
1.571379955759741320e-01
2.413455486397650118e-01
