5.921874999999999778e-01
1.009895833333333215e+00
1.044791666666666563e+00
1.463020833333333215e+00
1.497916666666666563e+00
1.973437499999999956e+00
2.426562500000000178e+00
2.484375000000000000e+00
2.519270833333333126e+00
3.053645833333333393e+00
3.506250000000000089e+00
4.017187500000000355e+00
4.528125000000000178e+00
5.003645833333333570e+00
5.479687499999999822e+00
6.025520833333333215e+00
6.536458333333333037e+00
7.047395833333332860e+00
7.070312500000000000e+00
7.523437500000000000e+00
7.558333333333333570e+00
8.062500000000000000e+00
8.335937500000000000e+00
8.603125000000000355e+00
9.079166666666665719e+00
9.566666666666666430e+00
1.010052083333333250e+01
1.058854166666666607e+01
1.064635416666666679e+01
1.106406250000000036e+01
1.109895833333333393e+01
1.115729166666666572e+01
1.160989583333333286e+01
1.163333333333333286e+01
1.210937500000000000e+01
1.259687500000000071e+01
1.304947916666666607e+01
1.354895833333333321e+01
1.358385416666666679e+01
1.400156250000000036e+01
1.403645833333333393e+01
1.451249999999999929e+01
1.454739583333333286e+01
1.505833333333333357e+01
1.556874999999999964e+01
1.607968749999999858e+01
1.613802083333333215e+01
1.661406249999999929e+01
1.709010416666666643e+01
1.715937500000000071e+01
1.754270833333333357e+01
1.757760416666666714e+01
1.763541666666666785e+01
1.765885416666666785e+01
1.816979166666666501e+01
1.865729166666666572e+01
