5.687499999999999778e-01
5.921874999999999778e-01
6.270833333333333259e-01
1.044791666666666563e+00
1.439583333333333215e+00
1.463020833333333215e+00
1.497916666666666563e+00
1.520833333333333259e+00
2.031770833333333304e+00
2.484375000000000000e+00
2.519270833333333126e+00
3.018749999999999822e+00
3.564062499999999911e+00
4.075000000000000178e+00
4.528125000000000178e+00
4.585937500000000000e+00
5.061979166666666252e+00
5.572916666666666963e+00
6.083854166666666785e+00
6.629166666666666430e+00
7.128645833333333570e+00
7.616145833333333393e+00
8.150000000000000355e+00
8.719270833333332860e+00
8.811979166666667140e+00
9.114062499999999289e+00
9.589583333333333570e+00
1.010052083333333250e+01
1.055364583333333250e+01
1.106406250000000036e+01
1.148229166666666679e+01
1.154010416666666572e+01
1.157499999999999929e+01
1.205104166666666643e+01
1.256197916666666714e+01
1.304947916666666607e+01
1.358385416666666679e+01
1.405989583333333393e+01
1.409427083333333286e+01
1.460520833333333357e+01
1.505833333333333357e+01
1.508124999999999893e+01
1.511614583333333250e+01
1.559218749999999964e+01
1.598697916666666607e+01
1.601041666666666785e+01
1.607968749999999858e+01
1.610312499999999858e+01
1.655572916666666572e+01
1.661406249999999929e+01
1.709010416666666643e+01
1.712447916666666714e+01
1.715937500000000071e+01
1.765885416666666785e+01
1.769375000000000142e+01
1.805364583333333428e+01
1.814635416666666501e+01
1.865729166666666572e+01
1.958593750000000000e+01
