1.161458333333333370e-01
5.921874999999999778e-01
1.009895833333333215e+00
1.044791666666666563e+00
1.520833333333333259e+00
2.008333333333333304e+00
2.484375000000000000e+00
2.519270833333333126e+00
3.053645833333333393e+00
3.506250000000000089e+00
3.958854166666666785e+00
4.017187500000000355e+00
4.528125000000000178e+00
5.038541666666666252e+00
5.479687499999999822e+00
6.025520833333333215e+00
6.536458333333333037e+00
7.047395833333332860e+00
7.581249999999999822e+00
7.616145833333333393e+00
8.068749999999999645e+00
8.579687500000000355e+00
9.055729166666665719e+00
9.589583333333333570e+00
1.007760416666666714e+01
1.010052083333333250e+01
1.055364583333333250e+01
1.058854166666666607e+01
1.100624999999999964e+01
1.102968749999999964e+01
1.106406250000000036e+01
1.151718750000000036e+01
1.154010416666666572e+01
1.199322916666666572e+01
1.202812499999999929e+01
1.205104166666666643e+01
1.246927083333333286e+01
1.250416666666666643e+01
1.256197916666666714e+01
1.304947916666666607e+01
1.307291666666666607e+01
1.352552083333333321e+01
1.403645833333333393e+01
1.405989583333333393e+01
1.451249999999999929e+01
1.498854166666666643e+01
1.553437499999999893e+01
1.607968749999999858e+01
