1.241591183814443750e-01
1.507831089822655179e-01
8.534987323922361702e-01
7.797825706570690185e-01
1.357812986606265482e-01
1.319688233534894728e-01
1.328494451677496579e-01
2.094975704381141779e-01
