1.336625647668393813e-01
1.585987983221856801e-01
9.686479425212279892e-01
9.295078106601774026e-01
1.615212527964205724e-01
1.502586844050258774e-01
1.610515569167942918e-01
2.393873697461360861e-01
