1.223283678756476728e-01
1.540641650606507096e-01
9.714239059438275481e-01
9.289583169793547146e-01
1.574944071588366967e-01
1.388026607538802581e-01
1.518631955079121909e-01
2.316945240925938898e-01
